10.OX
..........
..........
..........
......O...
....O..O..
..........
..O.O...O.
..........
.........O
.......O..
