15.oX
..........
.......o..
.........o
..........
...o..o.o.
..........
..........
.........o
..........
......o...
..........
..........
..o....o..
..........
o......o..
