12.OX
...........O
.........O..
..O........O
............
O...........
............
..........O.
............
............
.O..........
............
..O.........
